############
#GG..####.##
#GG..###...#
#GG.....BB.#
#GG..#.#.B.#
#GG###.#.B.#
####.B.#B.P#
####..B#.B.#
####.B..B..#
####..##...#
############