###################
############..GGGG#
############..GGGG#
#....#..B.B...GGGG#
#.BBB#B..B.#..GGGG#
#..B.....B.#..GGGG#
#.BB.#B.B.B########
#..B.#.....########
##.################
#....#....#########
#.....B...#########
#..BB#BB..P########
#....#....#########
###################