#####
##..#
##..#
#GB.#
#PBG#
#####