#######
##G.G##
#GBBBG#
#.BPB.#
#GBBBG#
##G.G##
#######