#########
#..#....#
#.B.G...#
#..#P...#
#.......#
#.......#
#########