###################
#.................#
#.................#
#.................#
#.................#
#.................#
#.................#
#........P........#
#.................#
#.................#
#.................#
#.................#
#.B.............G.#
###################