############
#....###...#
#.BB.....#P#
#.B.#GGG...#
#...########
############