##########
#..##....#
#.B..G...#
#..#P....#
#........#
#........#
#........#
##########