#######
#P....#
#.#.#.#
#GBBG.#
#...###
#######