###########
#...##....#
#.B...B...#
#.G...G...#
#.....P...#
#.........#
#.........#
###########