###################
#####...###########
#####B..###########
#####..B###########
###..B.B.##########
###.#.##.##########
#...#.##.#####..GG#
#.B..B..........GG#
#####.###.#P##..GG#
#####.....#########
###################