###########
#######G..#
#######G#.#
#######G#.#
#.P.B.B.B.#
#.#.#.#.###
#.......###
###########