#######
#G.B.G#
#.BPB.#
#G.B.G#
#######