##############
#GG..#.....###
#GG..#.B..B..#
#GG..#B####..#
#GG....P.##..#
#GG..#.#..B.##
######.##B.B.#
###.B..B.B.B.#
###....#.....#
##############