#######
#..G..#
#..B..#
#..P..#
#..W..#
#######