############
#....##....#
#.B..#..G..#
#..#.#..#..#
#.G..#..B..#
#....P.....#
#..........#
#..........#
############