#######
#.....#
#.B.G.#
#..P..#
#.....#
#.....#
#######