#####
#G..#
#.B.#
##P##
#.B.#
#..G#
#####