#########
#G##G##G#
#.......#
#..BBB..#
#G.BPB.G#
#..BBB..#
#.......#
#G##G##G#
#########