#####
#G###
#G###
#.B.#
#B#.#
#..P#
#####