########
###.GGP#
###.BB.#
####.###
####.###
####.###
#....###
#.#...##
#...#.##
###...##
########