########
#......#
#P#.BB.#
#GG...##
########