#########
#...#...#
#.B.G...#
#...P...#
#.......#
#.......#
#########